alias n-a= 'npm audit'
n-af =	'npm audit fix'
n-b	= 'npm build'
n-c	= 'npm cache'
n-ca =	'npm cache add'	
n-cc =	'npm cache clean'	
n-cv =	'npm cache verify'
n-h	= 'npm help'	
n-i	= 'npm install'	
n-id	= 'npm install --save-dev'
n-ig	= 'npm install -g'
n-in	= 'npm init'
n-l	= 'npm login'
n-lo	= 'npm logout'
n-p	= 'npm publish'
n-pc	= 'npm pack'
n-r	= 'npm run'
n-rm	= 'npm uninstall'
n-u	= 'npm update'
n-ug	= 'npm update -g'
n-up	= 'npm unpublish'
